ID,Name,Nombre d’inscrits,Nombre de procurations,Nombre de votants,% votants,Nombre abstention,% abstention,Nombre de bulletins blancs,% blancs,Nombre de bulletins nuls,% nuls,Nombre de bulletins exprimés,% exprimés,MACRON,LE PEN,% MACRON,% LE PEN
132,"Ecole Maternelle ""Sully""",963,81,756,"78,50",207,"21,50",61,"8,07",11,"1,46",684,"90,48",586,98,"85,67","14,33"
133,"Ecole Maternelle ""Sully""",949,105,743,"78,29",206,"21,71",58,"7,81",10,"1,35",675,"90,85",611,64,"90,52","9,48"
134,"Ecole Maternelle ""Sully""",1001,77,764,"76,32",237,"23,68",78,"10,21",8,"1,05",678,"88,74",593,85,"87,46","12,54"
141,"Ecole Primaire ""Noire""",978,69,745,"76,18",233,"23,82",45,"6,04",19,"2,55",681,"91,41",612,69,"89,87","10,13"
142,"Ecole Primaire ""Noire""",954,97,723,"75,79",231,"24,21",42,"5,81",11,"1,52",670,"92,67",620,50,"92,54","7,46"
143,"Ecole Primaire ""Noire""",966,108,753,"77,95",213,"22,05",57,"7,57",12,"1,59",684,"90,84",607,77,"88,74","11,26"
144,"Ecole Primaire ""Noire""",1008,81,779,"77,28",229,"22,72",50,"6,42",16,"2,05",713,"91,53",624,89,"87,52","12,48"
152,"Ecole Primaire ""Léon Say""",998,100,798,"79,96",200,"20,04",53,"6,64",19,"2,38",726,"90,98",627,99,"86,36","13,64"
154,"Ecole Primaire ""Léon Say""",874,110,711,"81,35",163,"18,65",59,"8,30",15,"2,11",637,"89,59",562,75,"88,23","11,77"
173,"Ecole Maternelle ""Fellonneau""",990,89,807,"81,52",183,"18,48",61,"7,56",18,"2,23",728,"90,21",662,66,"90,93","9,07"
231,"Ecole Primaire ""Gay Lussac""",905,59,676,"74,70",229,"25,30",57,"8,43",17,"2,51",602,"89,05",513,89,"85,22","14,78"
242,"Ecole Maternelle ""Agenêts""",863,89,683,"79,14",180,"20,86",68,"9,96",11,"1,61",604,"88,43",531,73,"87,91","12,09"
243,"Ecole Maternelle ""Agenêts""",825,89,653,"79,15",172,"20,85",48,"7,35",12,"1,84",593,"90,81",517,76,"87,18","12,82"
244,"Ecole Maternelle ""Agenêts""",800,42,610,"76,25",190,"23,75",67,"10,98",10,"1,64",533,"87,38",449,84,"84,24","15,76"
261,"Ecole Elementaire ""Coudray""",845,110,686,"81,18",159,"18,82",48,"7,00",11,"1,60",627,"91,40",547,80,"87,24","12,76"
272,"Ecole Maternelle ""Port Boyer""",923,61,673,"72,91",250,"27,09",45,"6,69",13,"1,93",615,"91,38",530,85,"86,18","13,82"
273,"Ecole Maternelle ""Port Boyer""",857,66,631,"73,63",226,"26,37",49,"7,77",13,"2,06",569,"90,17",512,57,"89,98","10,02"
351,"Ecole Maternelle ""Gustave Roch""",950,62,689,"72,53",261,"27,47",46,"6,68",19,"2,76",624,"90,57",534,90,"85,58","14,42"
353,"Ecole Maternelle ""Gustave Roch""",925,59,653,"70,59",272,"29,41",62,"9,49",17,"2,60",574,"87,90",500,74,"87,11","12,89"
371,"Ecole Maternelle ""Jacques Tati""",950,48,715,"75,26",235,"24,74",50,"6,99",11,"1,54",654,"91,47",549,105,"83,94","16,06"
381,"Ecole Elementaire ""Ledru Rollin""",845,30,599,"70,89",246,"29,11",51,"8,51",14,"2,34",534,"89,15",419,115,"78,46","21,54"
382,"Ecole Elementaire ""Ledru Rollin""",873,59,653,"74,80",220,"25,20",58,"8,88",11,"1,68",584,"89,43",509,75,"87,16","12,84"
384,"Ecole Elementaire ""Ledru Rollin""",913,102,679,"74,37",234,"25,63",57,"8,39",12,"1,77",610,"89,84",523,87,"85,74","14,26"
415,"Ecole Maternelle ""Harouys""",796,92,635,"79,77",161,"20,23",70,"11,02",9,"1,42",556,"87,56",488,68,"87,77","12,23"
432,"Ecole Elementaire ""Mutualité""",933,62,715,"76,63",218,"23,37",61,"8,53",7,"0,98",647,"90,49",585,62,"90,42","9,58"
444,"Ecole Elementaire ""Garennes""",940,64,690,"73,40",250,"26,60",62,"8,99",7,"1,01",621,"90,00",553,68,"89,05","10,95"
451,"Ecole Primaire ""Réformes""",895,80,687,"76,76",208,"23,24",47,"6,84",19,"2,77",621,"90,39",560,61,"90,18","9,82"
472,"Groupe Scolaire ""Jean Zay""",903,33,592,"65,56",311,"34,44",46,"7,77",18,"3,04",528,"89,19",445,83,"84,28","15,72"
511,"Ecole Elementaire ""Grand Carcouet""",901,61,629,"69,81",272,"30,19",48,"7,63",5,"0,79",576,"91,57",471,105,"81,77","18,23"
521,"Ecole Maternelle ""Jacques Prévert""",789,24,461,"58,43",328,"41,57",40,"8,68",17,"3,69",404,"87,64",319,85,"78,96","21,04"
525,"Ecole Maternelle ""Jacques Prévert""",990,69,724,"73,13",266,"26,87",57,"7,87",11,"1,52",656,"90,61",559,97,"85,21","14,79"
532,"Ecole Elémentaire ""Dervallières Chézine""",819,15,475,"58,00",344,"42,00",36,"7,58",10,"2,11",429,"90,32",338,91,"78,79","21,21"
544,"Ecole Elémentaire ""Fraternité""",951,116,726,"76,34",225,"23,66",48,"6,61",9,"1,24",669,"92,15",610,59,"91,18","8,82"
552,"Ecole Elementaire ""Contrie""",1015,67,782,"77,04",233,"22,96",78,"9,97",11,"1,41",693,"88,62",592,101,"85,43","14,57"
561,"Ecole Maternelle ""Lucie Aubrac""",905,49,591,"65,30",314,"34,70",46,"7,78",15,"2,54",530,"89,68",434,96,"81,89","18,11"
562,"Ecole Maternelle ""Lucie Aubrac""",892,66,465,"52,13",427,"47,87",32,"6,88",13,"2,80",420,"90,32",322,98,"76,67","23,33"
613,"Ecole Maternelle ""Plantes""",875,82,691,"78,97",184,"21,03",56,"8,10",9,"1,30",626,"90,59",552,74,"88,18","11,82"
615,"Ecole Maternelle ""Plantes""",889,99,714,"80,31",175,"19,69",48,"6,72",2,"0,28",664,"93,00",585,79,"88,10","11,90"
622,"Ecole Maternelle ""Longchamp""",892,43,682,"76,46",210,"23,54",38,"5,57",8,"1,17",636,"93,26",554,82,"87,11","12,89"
632,"Groupe Scolaire ""Barberie Mulotière""",929,85,741,"79,76",188,"20,24",48,"6,48",14,"1,89",679,"91,63",619,60,"91,16","8,84"
654,"Ecole Maternelle ""Baut""",961,99,704,"73,26",257,"26,74",44,"6,25",13,"1,85",647,"91,90",585,62,"90,42","9,58"
661,"Ecole Maternelle ""Chauvinière""",908,13,613,"67,51",295,"32,49",58,"9,46",12,"1,96",543,"88,58",442,101,"81,40","18,60"
662,"Ecole Maternelle ""Chauvinière""",923,33,647,"70,10",276,"29,90",44,"6,80",20,"3,09",583,"90,11",471,112,"80,79","19,21"
712,"Ecole Elementaire ""Marsauderies""",906,69,716,"79,03",190,"20,97",57,"7,96",11,"1,54",648,"90,50",576,72,"88,89","11,11"
733,"Ecole Maternelle ""Maurice Macé""",897,40,661,"73,69",236,"26,31",72,"10,89",34,"5,14",555,"83,96",431,124,"77,66","22,34"
742,"Ecole Primaire ""Julien Gracq""",993,42,733,"73,82",260,"26,18",58,"7,91",26,"3,55",649,"88,54",532,117,"81,97","18,03"
761,"Ecole Maternelle ""Louis Pergaud""",994,65,826,"83,10",168,"16,90",65,"7,87",11,"1,33",750,"90,80",646,104,"86,13","13,87"
763,"Ecole Maternelle ""Louis Pergaud""",1021,82,838,"82,08",183,"17,92",69,"8,23",15,"1,79",754,"89,98",655,99,"86,87","13,13"
112,"Ecole Maternelle ""Molière""",1025,99,774,"75,51",251,"24,49",73,"9,43",14,"1,81",687,"88,76",616,71,"89,67","10,33"
121,"Groupe Scolaire ""Stalingrad""",967,119,715,"73,94",252,"26,06",49,"6,85",12,"1,68",654,"91,47",588,66,"89,91","10,09"
163,"Ecole Primaire ""Charles Lebourg""",882,57,654,"74,15",228,"25,85",39,"5,96",17,"2,60",598,"91,44",529,69,"88,46","11,54"
172,"Ecole Maternelle ""Fellonneau""",944,102,736,"77,97",208,"22,03",65,"8,83",3,"0,41",668,"90,76",589,79,"88,17","11,83"
182,"Ecole Primaire ""Jean Jaures""",559,59,434,"77,64",125,"22,36",26,"5,99",6,"1,38",402,"92,63",371,31,"92,29","7,71"
223,"Ecole Maternelle ""Louis Guiotton""",854,86,701,"82,08",153,"17,92",44,"6,28",10,"1,43",647,"92,30",595,52,"91,96","8,04"
224,"Ecole Maternelle ""Louis Guiotton""",899,83,660,"73,41",239,"26,59",49,"7,42",11,"1,67",600,"90,91",529,71,"88,17","11,83"
232,"Ecole Primaire ""Gay Lussac""",888,77,721,"81,19",167,"18,81",54,"7,49",16,"2,22",651,"90,29",552,99,"84,79","15,21"
264,"Ecole Elementaire ""Coudray""",904,65,695,"76,88",209,"23,12",67,"9,64",17,"2,45",611,"87,91",526,85,"86,09","13,91"
331,"Ecole Elementaire ""André Lermite""",1013,97,772,"76,21",241,"23,79",66,"8,55",14,"1,81",692,"89,64",621,71,"89,74","10,26"
332,"Ecole Elementaire ""André Lermite""",961,77,755,"78,56",206,"21,44",78,"10,33",13,"1,72",664,"87,95",581,83,"87,50","12,50"
343,"Ecole Elementaire ""Emile Péhant""",954,91,709,"74,32",245,"25,68",54,"7,62",13,"1,83",642,"90,55",597,45,"92,99","7,01"
355,"Ecole Maternelle ""Gustave Roch""",1119,102,895,"79,98",224,"20,02",59,"6,59",13,"1,45",823,"91,96",764,59,"92,83","7,17"
372,"Ecole Maternelle ""Jacques Tati""",835,29,580,"69,46",255,"30,54",53,"9,14",12,"2,07",515,"88,79",411,104,"79,81","20,19"
411,"Ecole ""Harouys""",572,56,438,"76,57",134,"23,43",34,"7,76",7,"1,60",397,"90,64",346,51,"87,15","12,85"
421,"Ecole Elémentaire ""Boccage""",866,85,683,"78,87",183,"21,13",42,"6,15",13,"1,90",628,"91,95",540,88,"85,99","14,01"
433,"Ecole Elementaire ""Mutualité""",929,207,757,"81,49",172,"18,51",70,"9,25",17,"2,25",670,"88,51",593,77,"88,51","11,49"
434,"Ecole Elementaire ""Mutualité""",991,73,739,"74,57",252,"25,43",56,"7,58",16,"2,17",667,"90,26",570,97,"85,46","14,54"
443,"Ecole Elementaire ""Garennes""",917,82,698,"76,12",219,"23,88",54,"7,74",13,"1,86",631,"90,40",583,48,"92,39","7,61"
452,"Ecole Primaire ""Réformes""",919,98,750,"81,61",169,"18,39",48,"6,40",18,"2,40",684,"91,20",617,67,"90,20","9,80"
453,"Ecole Primaire ""Réformes""",1082,57,804,"74,31",278,"25,69",85,"10,57",19,"2,36",700,"87,06",634,66,"90,57","9,43"
462,"Ecole Maternelle ""Plessis-Cellier""",885,55,664,"75,03",221,"24,97",52,"7,83",11,"1,66",601,"90,51",544,57,"90,52","9,48"
471,"Groupe Scolaire ""Jean Zay""",819,13,504,"61,54",315,"38,46",57,"11,31",11,"2,18",436,"86,51",323,113,"74,08","25,92"
512,"Ecole Elementaire ""Grand Carcouet""",815,63,607,"74,48",208,"25,52",48,"7,91",14,"2,31",545,"89,79",446,99,"81,83","18,17"
513,"Ecole Elementaire ""Grand Carcouet""",883,44,622,"70,44",261,"29,56",44,"7,07",11,"1,77",567,"91,16",480,87,"84,66","15,34"
524,"Ecole Maternelle ""Jacques Prévert""",905,49,718,"79,34",187,"20,66",56,"7,80",16,"2,23",646,"89,97",575,71,"89,01","10,99"
533,"Ecole Elémentaire ""Dervallières Chézine""",951,0,698,"73,40",253,"26,60",41,"5,87",8,"1,15",649,"92,98",559,90,"86,13","13,87"
565,"Ecole Maternelle ""Lucie Aubrac""",1015,65,747,"73,60",268,"26,40",56,"7,50",18,"2,41",673,"90,09",602,71,"89,45","10,55"
612,"Ecole Maternelle ""Plantes""",926,65,714,"77,11",212,"22,89",52,"7,28",15,"2,10",647,"90,62",576,71,"89,03","10,97"
653,"Ecole Maternelle ""Baut""",978,64,755,"77,20",223,"22,80",55,"7,28",23,"3,05",677,"89,67",585,92,"86,41","13,59"
671,"Ecole Primaire ""Françoise Dolto""",852,24,520,"61,03",332,"38,97",33,"6,35",11,"2,12",476,"91,54",369,107,"77,52","22,48"
725,"Ecole Maternelle ""Urbain Leverrier""",982,58,829,"84,42",153,"15,58",71,"8,56",13,"1,57",745,"89,87",653,92,"87,65","12,35"
751,"Ecole Elementaire ""Beaujoire""",1035,79,775,"74,88",260,"25,12",78,"10,06",14,"1,81",683,"88,13",584,99,"85,51","14,49"
764,"Ecole Maternelle ""Louis Pergaud""",918,44,686,"74,73",232,"25,27",55,"8,02",17,"2,48",614,"89,50",487,127,"79,32","20,68"
131,"Ecole Maternelle ""Sully""",1092,106,834,"76,37",258,"23,63",83,"9,95",5,"0,60",746,"89,45",664,82,"89,01","10,99"
153,"Ecole Primaire ""Léon Say""",999,73,800,"80,08",199,"19,92",64,"8,00",25,"3,13",711,"88,88",614,97,"86,36","13,64"
161,"Ecole Primaire ""Charles Lebourg""",928,82,716,"77,16",212,"22,84",67,"9,36",10,"1,40",639,"89,25",565,74,"88,42","11,58"
222,"Ecole Maternelle ""Louis Guiotton""",1056,69,746,"70,64",310,"29,36",60,"8,04",14,"1,88",672,"90,08",587,85,"87,35","12,65"
253,"Ecole Elementaire ""François Dallet""",1033,57,789,"76,38",244,"23,62",68,"8,62",21,"2,66",700,"88,72",574,126,"82,00","18,00"
262,"Ecole Elementaire ""Coudray""",932,67,709,"76,07",223,"23,93",67,"9,45",13,"1,83",629,"88,72",557,72,"88,55","11,45"
271,"Ecole Maternelle ""Port Boyer""",899,32,629,"69,97",270,"30,03",63,"10,02",16,"2,54",550,"87,44",433,117,"78,73","21,27"
314,"Ecole Elementaire ""Chêne d'Aron""",1027,122,800,"77,90",227,"22,10",56,"7,00",13,"1,63",731,"91,38",650,81,"88,92","11,08"
341,"Ecole Elementaire ""Emile Péhant""",954,86,721,"75,58",233,"24,42",56,"7,77",20,"2,77",645,"89,46",582,63,"90,23","9,77"
362,"Ecole Maternelle ""Louise Michel""",830,38,649,"78,19",181,"21,81",63,"9,71",15,"2,31",571,"87,98",484,87,"84,76","15,24"
365,"Ecole Maternelle ""Louise Michel""",765,35,505,"66,01",260,"33,99",34,"6,73",12,"2,38",459,"90,89",386,73,"84,10","15,90"
413,"Ecole Maternelle ""Harouys""",897,125,709,"79,04",188,"20,96",47,"6,63",22,"3,10",640,"90,27",562,78,"87,81","12,19"
416,"Ecole ""Harouys""",869,72,650,"74,80",219,"25,20",55,"8,46",9,"1,38",586,"90,15",514,72,"87,71","12,29"
422,"Ecole Elémentaire ""Boccage""",902,86,699,"77,49",203,"22,51",48,"6,87",18,"2,58",633,"90,56",555,78,"87,68","12,32"
423,"Ecole Elémentaire ""Boccage""",925,106,748,"80,86",177,"19,14",56,"7,49",10,"1,34",682,"91,18",618,64,"90,62","9,38"
431,"Ecole ""Mutualité""",929,96,732,"78,79",197,"21,21",53,"7,24",17,"2,32",662,"90,44",598,64,"90,33","9,67"
473,"Groupe Scolaire ""Jean Zay""",931,37,638,"68,53",293,"31,47",66,"10,34",14,"2,19",558,"87,46",451,107,"80,82","19,18"
522,"Ecole Maternelle ""Jacques Prévert""",816,42,543,"66,54",273,"33,46",51,"9,39",7,"1,29",485,"89,32",396,89,"81,65","18,35"
534,"Ecole Elémentaire ""Dervallières Chézine""",980,64,702,"71,63",278,"28,37",50,"7,12",13,"1,85",639,"91,03",528,111,"82,63","17,37"
541,"Ecole Elémentaire ""Fraternité""",1046,103,806,"77,06",240,"22,94",72,"8,93",10,"1,24",724,"89,83",638,86,"88,12","11,88"
543,"Ecole Elémentaire ""Fraternité""",1090,82,863,"79,17",227,"20,83",82,"9,50",24,"2,78",757,"87,72",659,98,"87,05","12,95"
551,"Ecole Elementaire ""Contrie""",808,75,614,"75,99",194,"24,01",40,"6,51",12,"1,95",562,"91,53",501,61,"89,15","10,85"
553,"Ecole Elementaire ""Contrie""",978,88,787,"80,47",191,"19,53",69,"8,77",11,"1,40",707,"89,83",616,91,"87,13","12,87"
614,"Ecole Maternelle ""Plantes""",881,104,682,"77,41",199,"22,59",51,"7,48",10,"1,47",621,"91,06",548,73,"88,24","11,76"
621,"Ecole Maternelle ""Longchamp""",894,63,729,"81,54",165,"18,46",44,"6,04",19,"2,61",666,"91,36",574,92,"86,19","13,81"
642,"Ecole Maternelle ""Côte d'Or""",882,49,634,"71,88",248,"28,12",45,"7,10",11,"1,74",578,"91,17",487,91,"84,26","15,74"
651,"Ecole Maternelle ""Baut""",869,45,671,"77,22",198,"22,78",48,"7,15",19,"2,83",604,"90,01",519,85,"85,93","14,07"
711,"Ecole Elementaire ""Marsauderies""",935,82,777,"83,10",158,"16,90",45,"5,79",8,"1,03",724,"93,18",662,62,"91,44","8,56"
713,"Ecole Elementaire ""Marsauderies""",988,40,681,"68,93",307,"31,07",44,"6,46",24,"3,52",613,"90,01",484,129,"78,96","21,04"
721,"Ecole Maternelle ""Urbain Leverrier""",1059,48,724,"68,37",335,"31,63",51,"7,04",17,"2,35",656,"90,61",526,130,"80,18","19,82"
731,"Ecole Maternelle ""Maurice Macé""",966,51,784,"81,16",182,"18,84",70,"8,93",10,"1,28",704,"89,80",608,96,"86,36","13,64"
732,"Ecole Maternelle ""Maurice Macé""",955,67,750,"78,53",205,"21,47",58,"7,73",24,"3,20",668,"89,07",564,104,"84,43","15,57"
754,"Ecole Elementaire ""Beaujoire""",882,24,534,"60,54",348,"39,46",46,"8,61",10,"1,87",478,"89,51",350,128,"73,22","26,78"
111,"Ecole Maternelle ""Molière""",863,110,679,"78,68",184,"21,32",60,"8,84",17,"2,50",602,"88,66",529,73,"87,87","12,13"
122,"Groupe Scolaire ""Stalingrad""",925,87,704,"76,11",221,"23,89",76,"10,80",18,"2,56",610,"86,65",552,58,"90,49","9,51"
151,"Ecole Primaire ""Léon Say""",937,96,749,"79,94",188,"20,06",53,"7,08",18,"2,40",678,"90,52",586,92,"86,43","13,57"
162,"Ecole Primaire ""Charles Lebourg""",928,74,733,"78,99",195,"21,01",60,"8,19",11,"1,50",662,"90,31",589,73,"88,97","11,03"
174,"Ecole Maternelle ""Fellonneau""",963,92,764,"79,34",199,"20,66",51,"6,68",6,"0,79",707,"92,54",645,62,"91,23","8,77"
175,"Ecole Maternelle ""Fellonneau""",943,91,716,"75,93",227,"24,07",57,"7,96",14,"1,96",645,"90,08",582,63,"90,23","9,77"
234,"Ecole Primaire ""Gay Lussac""",870,67,658,"75,63",212,"24,37",38,"5,78",20,"3,04",600,"91,19",515,85,"85,83","14,17"
263,"Ecole Elementaire ""Coudray""",845,73,677,"80,12",168,"19,88",55,"8,12",6,"0,89",616,"90,99",533,83,"86,53","13,47"
274,"Ecole Maternelle ""Port Boyer""",897,100,744,"82,94",153,"17,06",71,"9,54",8,"1,08",665,"89,38",561,104,"84,36","15,64"
275,"Ecole Maternelle ""Port Boyer""",830,50,597,"71,93",233,"28,07",36,"6,03",10,"1,68",551,"92,29",457,94,"82,94","17,06"
312,"Ecole Elementaire ""Chêne d'Aron""",980,95,732,"74,69",248,"25,31",59,"8,06",12,"1,64",661,"90,30",605,56,"91,53","8,47"
352,"Ecole Maternelle ""Gustave Roch""",931,65,674,"72,40",257,"27,60",47,"6,97",14,"2,08",613,"90,95",548,65,"89,40","10,60"
354,"Ecole Maternelle ""Gustave Roch""",1055,,820,"77,73",235,"22,27",51,"6,22",18,"2,20",751,"91,59",687,64,"91,48","8,52"
361,"Ecole Maternelle ""Louise Michel""",1067,83,811,"76,01",256,"23,99",70,"8,63",16,"1,97",725,"89,40",633,92,"87,31","12,69"
363,"Ecole Maternelle ""Louise Michel""",913,35,645,"70,65",268,"29,35",47,"7,29",13,"2,02",585,"90,70",490,95,"83,76","16,24"
373,"Ecole Maternelle ""Jacques Tati""",859,76,630,"73,34",229,"26,66",51,"8,10",12,"1,90",567,"90,00",493,74,"86,95","13,05"
385,"Ecole Elementaire ""Ledru Rollin""",981,59,759,"77,37",222,"22,63",47,"6,19",10,"1,32",702,"92,49",637,65,"90,74","9,26"
414,"Ecole Maternelle ""Harouys""",739,74,551,"74,56",188,"25,44",50,"9,07",8,"1,45",493,"89,47",424,69,"86,00","14,00"
424,"Ecole Elémentaire ""Boccage""",909,105,688,"75,69",221,"24,31",43,"6,25",19,"2,76",626,"90,99",571,55,"91,21","8,79"
425,"Ecole Elémentaire ""Boccage""",892,60,688,"77,13",204,"22,87",55,"7,99",9,"1,31",624,"90,70",567,57,"90,87","9,13"
441,"Ecole Elementaire ""Garennes""",948,71,721,"76,05",227,"23,95",42,"5,83",6,"0,83",673,"93,34",606,67,"90,04","9,96"
442,"Ecole Elementaire ""Garennes""",924,,705,"76,30",219,"23,70",45,"6,38",13,"1,84",647,"91,77",594,53,"91,81","8,19"
445,"Ecole Elementaire ""Garennes""",818,70,622,"76,04",196,"23,96",54,"8,68",12,"1,93",556,"89,39",475,81,"85,43","14,57"
461,"Ecole Maternelle ""Plessis-Cellier""",869,74,647,"74,45",222,"25,55",52,"8,04",16,"2,47",579,"89,49",511,68,"88,26","11,74"
531,"Ecole Elémentaire ""Dervallières Chézine""",1042,48,606,"58,16",436,"41,84",49,"8,09",13,"2,15",544,"89,77",442,102,"81,25","18,75"
545,"Ecole Elémentaire ""Fraternité""",1001,223,786,"78,52",215,"21,48",59,"7,51",15,"1,91",712,"90,59",637,75,"89,47","10,53"
563,"Ecole Maternelle ""Lucie Aubrac""",918,18,586,"63,83",332,"36,17",52,"8,87",13,"2,22",521,"88,91",406,115,"77,93","22,07"
611,"Ecole Maternelle ""Plantes""",932,56,723,"77,58",209,"22,42",50,"6,92",15,"2,07",658,"91,01",581,77,"88,30","11,70"
624,"Ecole Maternelle ""Longchamp""",935,54,724,"77,43",211,"22,57",64,"8,84",14,"1,93",646,"89,23",550,96,"85,14","14,86"
625,"Ecole Maternelle ""Longchamp""",998,82,748,"74,95",250,"25,05",70,"9,36",12,"1,60",666,"89,04",586,80,"87,99","12,01"
631,"Groupe Scolaire ""Barberie Mulotière""",971,90,795,"81,87",176,"18,13",60,"7,55",17,"2,14",718,"90,31",612,106,"85,24","14,76"
634,"Groupe Scolaire ""Barberie Mulotière""",892,41,706,"79,15",186,"20,85",52,"7,37",20,"2,83",634,"89,80",567,67,"89,43","10,57"
655,"Ecole Maternelle ""Baut""",959,87,735,"76,64",224,"23,36",46,"6,26",18,"2,45",671,"91,29",586,85,"87,33","12,67"
714,"Ecole Elementaire ""Marsauderies""",973,84,727,"74,72",246,"25,28",53,"7,29",14,"1,93",660,"90,78",572,88,"86,67","13,33"
715,"Ecole Elementaire ""Marsauderies""",1033,67,768,"74,35",265,"25,65",37,"4,82",13,"1,69",718,"93,49",593,125,"82,59","17,41"
722,"Ecole Maternelle ""Urbain Leverrier""",1017,45,699,"68,73",318,"31,27",54,"7,73",13,"1,86",632,"90,41",511,121,"80,85","19,15"
723,"Ecole Maternelle ""Urbain Leverrier""",964,35,601,"62,34",363,"37,66",48,"7,99",20,"3,33",533,"88,69",421,112,"78,99","21,01"
735,"Ecole Maternelle ""Maurice Macé""",1192,78,975,"81,80",217,"18,20",81,"8,31",14,"1,44",880,"90,26",781,99,"88,75","11,25"
741,"Ecole Primaire ""Julien Gracq""",1004,61,769,"76,59",235,"23,41",75,"9,75",22,"2,86",672,"87,39",566,106,"84,23","15,77"
113,"Ecole Maternelle ""Molière""",870,96,643,"73,91",227,"26,09",50,"7,78",13,"2,02",580,"90,20",551,29,"95,00","5,00"
114,"Ecole Maternelle ""Molière""",918,95,711,"77,45",207,"22,55",52,"7,31",15,"2,11",644,"90,58",578,66,"89,75","10,25"
123,"Groupe Scolaire ""Stalingrad""",959,90,709,"73,93",250,"26,07",75,"10,58",20,"2,82",614,"86,60",535,79,"87,13","12,87"
171,"Ecole Maternelle ""Fellonneau""",932,114,753,"80,79",179,"19,21",57,"7,57",13,"1,73",683,"90,70",610,73,"89,31","10,69"
181,"Ecole Primaire ""Jean Jaures""",921,128,564,"61,24",357,"38,76",34,"6,03",9,"1,60",521,"92,38",465,56,"89,25","10,75"
211,"Ecole Maternelle ""Henri Bergson""",1197,72,881,"73,60",316,"26,40",62,"7,04",15,"1,70",804,"91,26",729,75,"90,67","9,33"
212,"Ecole Maternelle ""Henri Bergson""",981,23,629,"64,12",352,"35,88",60,"9,54",9,"1,43",560,"89,03",480,80,"85,71","14,29"
213,"Ecole Maternelle ""Henri Bergson""",873,25,497,"56,93",376,"43,07",38,"7,65",11,"2,21",448,"90,14",365,83,"81,47","18,53"
221,"Ecole Maternelle ""Louis Guiotton""",931,74,696,"74,76",235,"25,24",48,"6,90",15,"2,16",633,"90,95",508,125,"80,25","19,75"
233,"Ecole Primaire ""Gay Lussac""",874,121,652,"74,60",222,"25,40",50,"7,67",13,"1,99",589,"90,34",506,83,"85,91","14,09"
241,"Ecole Maternelle ""Agenêts""",895,82,670,"74,86",225,"25,14",67,"10,00",8,"1,19",595,"88,81",526,69,"88,40","11,60"
251,"Ecole Elementaire ""François Dallet""",1027,75,771,"75,07",256,"24,93",70,"9,08",18,"2,33",683,"88,59",573,110,"83,89","16,11"
252,"Ecole Elementaire ""François Dallet""",987,193,800,"81,05",187,"18,95",73,"9,13",16,"2,00",711,"88,88",595,116,"83,68","16,32"
254,"Ecole Elementaire ""François Dallet""",1060,45,787,"74,25",273,"25,75",74,"9,40",17,"2,16",696,"88,44",612,84,"87,93","12,07"
311,"Ecole Elementaire ""Chêne d'Aron""",1176,105,884,"75,17",292,"24,83",63,"7,13",11,"1,24",810,"91,63",745,65,"91,98","8,02"
313,"Ecole Elementaire ""Chêne d'Aron""",1021,120,782,"76,59",239,"23,41",64,"8,18",13,"1,66",705,"90,15",630,75,"89,36","10,64"
333,"Ecole Elementaire ""André Lermite""",940,92,737,"78,40",203,"21,60",59,"8,01",11,"1,49",667,"90,50",591,76,"88,61","11,39"
334,"Ecole Elementaire ""André Lermite""",929,102,719,"77,40",210,"22,60",36,"5,01",18,"2,50",665,"92,49",596,69,"89,62","10,38"
335,"Ecole Elementaire ""André Lermite""",829,90,637,"76,84",192,"23,16",53,"8,32",7,"1,10",577,"90,58",506,71,"87,69","12,31"
342,"Ecole Elementaire ""Emile Péhant""",896,86,667,"74,44",229,"25,56",43,"6,45",11,"1,65",613,"91,90",570,43,"92,99","7,01"
364,"Ecole Maternelle ""Louise Michel""",1143,66,875,"76,55",268,"23,45",79,"9,03",19,"2,17",777,"88,80",665,112,"85,59","14,41"
383,"Ecole Elementaire ""Ledru Rollin""",945,65,746,"78,94",199,"21,06",69,"9,25",9,"1,21",668,"89,54",575,93,"86,08","13,92"
412,"Ecole Maternelle ""Harouys""",716,61,542,"75,70",174,"24,30",49,"9,04",6,"1,11",487,"89,85",401,86,"82,34","17,66"
463,"Ecole Maternelle ""Plessis-Cellier""",909,43,674,"74,15",235,"25,85",57,"8,46",19,"2,82",598,"88,72",506,92,"84,62","15,38"
523,"Ecole Maternelle ""Jacques Prévert""",818,28,517,"63,20",301,"36,80",30,"5,80",12,"2,32",475,"91,88",367,108,"77,26","22,74"
542,"Ecole Elémentaire ""Fraternité""",1075,110,861,"80,09",214,"19,91",60,"6,97",17,"1,97",784,"91,06",704,80,"89,80","10,20"
554,"Ecole Elementaire ""Contrie""",1012,50,746,"73,72",266,"26,28",71,"9,52",8,"1,07",667,"89,41",561,106,"84,11","15,89"
555,"Ecole Elementaire ""Contrie""",928,81,710,"76,51",218,"23,49",64,"9,01",4,"0,56",642,"90,42",575,67,"89,56","10,44"
564,"Ecole Maternelle ""Lucie Aubrac""",1029,37,632,"61,42",397,"38,58",54,"8,54",11,"1,74",567,"89,72",464,103,"81,83","18,17"
623,"Ecole Maternelle ""Longchamp""",877,122,668,"76,17",209,"23,83",54,"8,08",16,"2,40",598,"89,52",526,72,"87,96","12,04"
633,"Groupe Scolaire ""Barberie Mulotière""",896,32,673,"75,11",223,"24,89",56,"8,32",14,"2,08",603,"89,60",520,83,"86,24","13,76"
641,"Ecole Maternelle ""Côte d'Or""",952,82,776,"81,51",176,"18,49",63,"8,12",9,"1,16",704,"90,72",631,73,"89,63","10,37"
643,"Ecole Maternelle ""Côte d'Or""",892,55,692,"77,58",200,"22,42",66,"9,54",11,"1,59",615,"88,87",500,115,"81,30","18,70"
652,"Ecole Maternelle ""Baut""",887,44,661,"74,52",226,"25,48",44,"6,66",16,"2,42",601,"90,92",523,78,"87,02","12,98"
663,"Ecole Maternelle ""Chauvinière""",847,18,479,"56,55",368,"43,45",46,"9,60",6,"1,25",427,"89,14",339,88,"79,39","20,61"
664,"Ecole Maternelle ""Chauvinière""",866,26,549,"63,39",317,"36,61",36,"6,56",8,"1,46",505,"91,99",397,108,"78,61","21,39"
672,"Ecole Primaire ""Françoise Dolto""",967,34,692,"71,56",275,"28,44",62,"8,96",11,"1,59",619,"89,45",497,122,"80,29","19,71"
673,"Ecole Primaire ""Françoise Dolto""",1040,33,707,"67,98",333,"32,02",61,"8,63",20,"2,83",626,"88,54",493,133,"78,75","21,25"
724,"Ecole Maternelle ""Urbain Leverrier""",945,37,617,"65,29",328,"34,71",49,"7,94",17,"2,76",551,"89,30",456,95,"82,76","17,24"
734,"Ecole Maternelle ""Maurice Macé""",989,172,806,"81,50",183,"18,50",81,"10,05",16,"1,99",709,"87,97",626,83,"88,29","11,71"
743,"Ecole Primaire ""Julien Gracq""",1054,51,823,"78,08",231,"21,92",73,"8,87",19,"2,31",731,"88,82",601,130,"82,22","17,78"
744,"Ecole Primaire ""Julien Gracq""",1481,78,1140,"76,98",341,"23,02",93,"8,16",24,"2,11",1023,"89,74",862,161,"84,26","15,74"
752,"Ecole Elementaire ""Beaujoire""",1137,37,839,"73,79",298,"26,21",70,"8,34",13,"1,55",756,"90,11",594,162,"78,57","21,43"
753,"Ecole Elementaire ""Beaujoire""",994,53,720,"72,43",274,"27,57",66,"9,17",23,"3,19",631,"87,64",528,103,"83,68","16,32"
762,"Ecole Maternelle ""Louis Pergaud""",982,43,753,"76,68",229,"23,32",67,"8,90",17,"2,26",669,"88,84",554,115,"82,81","17,19"
765,"Ecole Maternelle ""Louis Pergaud""",1344,116,1120,"83,33",224,"16,67",77,"6,88",27,"2,41",1016,"90,71",855,161,"84,15","15,85"