RS,NUTS3,Fläche in km²,Einwohner insgesamt,Einwohner männlich,Einwohner weiblich,Einwohner je km2
01001,DEF01,"56,74",85942,42767,43175,1515
01002,DEF02,"118,65",246306,119835,126471,2076
01003,DEF03,"214,21",216253,103683,112570,1010
01004,DEF04,"71,63",79197,39118,40079,1106
01051,DEF05,"1428,15",132917,65512,67405,93
01053,DEF06,"1263,01",192999,94684,98315,153
01054,DEF07,"2082,76",163960,80319,83641,79
01055,DEF08,"1392,56",199574,96412,103162,143
01056,DEF09,"664,28",307471,150455,157016,463
01057,DEF0A,"1083,17",128304,62349,65955,118
01058,DEF0B,"2189,18",270378,133002,137376,124
01059,DEF0C,"2071,31",196839,97496,99343,95
01060,DEF0D,"1344,39",267503,131777,135726,199
01061,DEF0E,"1056,14",131457,65047,66410,124
02000,DE600,"755,3",1787408,873062,914346,2366
01062,DEF0F,"766,31",239614,117002,122612,313
03101,DE911,"192,18",251364,125001,126363,1308
03102,DE912,"223,92",101079,49898,51181,451
03103,DE913,"204,09",124045,61581,62464,608
03151,DE914,"1562,86",174205,87129,87076,111
03152,DE915,"1117,39",255653,126142,129511,229
03153,DE916,"965,29",138236,68245,69991,143
03154,DE917,"674,03",91500,45354,46146,136
03155,DE918,"1267,08",134896,66394,68502,106
03156,DE919,"636,02",73885,36192,37693,116
03157,DE91A,"534,97",132320,65493,66827,247
03158,DE91B,"722,56",120981,59846,61135,167
03241,DE929,"2290,86",1144481,559775,584706,500
03251,DE922,"1988,14",213976,106475,107501,108
03252,DE923,"796,15",148281,71606,76675,186
03254,DE925,"1206,03",277055,135007,142048,230
03255,DE926,"692,65",71659,35481,36178,103
03256,DE927,"1398,97",120632,59947,60685,86
03257,DE928,"675,57",156206,76229,79977,231
03351,DE931,"1545,20",177971,87543,90428,115
03352,DE932,"2057,55",198103,97064,101039,96
03353,DE933,"1245,03",248122,122089,126033,199
03354,DE934,"1220,72",50128,24991,25137,41
03355,DE935,"1323,68",180719,88448,92271,137
03356,DE936,"650,81",113579,56098,57481,175
03357,DE937,"2070,45",163253,82229,81024,79
03358,DE938,"1873,72",140264,70371,69893,75
03359,DE939,"1266,02",200054,99894,100160,158
03360,DE93A,"1454,22",93131,45631,47500,64
03361,DE93B,"787,97",134645,66140,68505,171
03401,DE941,"62,36",76323,37823,38500,1224
03402,DE942,"112,34",50694,25249,25445,451
03403,DE943,"102,99",163830,78259,85571,1591
03404,DE944,"119,80",162403,78275,84128,1356
03405,DE945,"106,79",75995,37244,38751,712
03451,DE946,"728,38",121435,59587,61848,167
03452,DE947,"1283,99",189199,93212,95987,147
03453,DE948,"1418,45",164734,83274,81460,116
03454,DE949,"2882,07",319488,162482,157006,111
03455,DE94A,"607,71",97900,47771,50129,161
03456,DE94B,"980,84",135662,67780,67882,138
03457,DE94C,"1067,74",167548,83431,84117,157
03458,DE94D,"1063,16",128608,63988,64620,121
03459,DE94E,"2121,63",358079,178475,179604,169
03460,DE94F,"812,63",137866,69535,68331,170
03461,DE94G,"821,29",89239,44649,44590,109
03462,DE94H,"656,57",57173,28071,29102,87
04011,DE501,"326,18",557464,274119,283345,1709
04012,DE502,"93,66",114025,56776,57249,1217
05111,DEA11,"217,41",612178,295896,316282,2816
05112,DEA12,"232,80",491231,241417,249814,2110
05113,DEA13,"210,34",582624,282565,300059,2770
05114,DEA14,"137,77",225144,109487,115657,1634
05116,DEA15,"170,47",259996,127512,132484,1525
05117,DEA16,"91,28",169278,81461,87817,1854
05119,DEA17,"77,09",210934,103284,107650,2736
05120,DEA18,"74,52",109499,53725,55774,1469
05122,DEA19,"89,54",158726,76948,81778,1773
05124,DEA1A,"168,39",350046,170822,179224,2079
05154,DEA1B,"1232,99",310337,154988,155349,252
05158,DEA1C,"407,22",483279,233448,249831,1187
05162,DEA1D,"576,52",450026,219650,230376,781
05166,DEA1E,"563,28",297661,145470,152191,528
05170,DEA1F,"1042,80",462664,226396,236268,444
05314,DEA22,"141,06",318809,151954,166855,2260
05315,DEA23,"405,02",1060582,516976,543606,2619
05316,DEA24,"78,87",163487,79590,83897,2073
05334,DEA2D,"706,95",553922,279260,274662,784
05358,DEA26,"941,37",262828,130522,132306,279
05362,DEA27,"704,71",466657,228450,238207,662
05366,DEA28,"1248,73",191165,94759,96406,153
05370,DEA29,"627,99",252527,124956,127571,402
05374,DEA2A,"918,84",273452,134670,138782,298
05378,DEA2B,"437,32",282729,137438,145291,647
05382,DEA2C,"1153,21",596213,292555,303658,517
05512,DEA31,"100,61",117143,57004,60139,1164
05513,DEA32,"104,94",260368,129267,131101,2481
05515,DEA33,"303,28",310039,148447,161592,1022
05554,DEA34,"1420,98",369666,184973,184693,260
05558,DEA35,"1112,04",218401,107953,110448,196
05562,DEA36,"761,31",617807,301893,315914,812
05566,DEA37,"1795,76",443374,220782,222592,247
05570,DEA38,"1319,41",277431,137265,140166,210
05711,DEA41,"258,82",333090,161148,171942,1287
05754,DEA42,"969,21",360642,180222,180420,372
05758,DEA43,"450,41",252122,123935,128187,560
05762,DEA44,"1201,42",144010,72006,72004,120
05766,DEA45,"1246,21",350750,172490,178260,281
05770,DEA46,"1152,41",313050,154488,158562,272
05774,DEA47,"1246,80",304332,152549,151783,244
05911,DEA51,"145,66",364742,177427,187315,2504
05913,DEA52,"280,71",586181,287846,298335,2088
05914,DEA53,"160,45",189044,92207,96837,1178
05915,DEA54,"226,43",179397,88166,91231,792
05916,DEA55,"51,42",155851,75940,79911,3031
05954,DEA56,"409,64",325954,158312,167642,796
05958,DEA57,"1960,17",263762,131764,131998,135
05962,DEA58,"1061,06",416171,204987,211184,392
05966,DEA59,"712,14",136365,68624,67741,191
05970,DEA5A,"1132,89",280800,139626,141174,248
05974,DEA5B,"1328,63",302995,151061,151934,228
05978,DEA5C,"543,21",396035,193438,202597,729
06411,DE711,"122,09",155353,78915,76438,1272
06412,DE712,"248,31",732688,362515,370173,2951
06413,DE713,"44,89",123734,61609,62125,2756
06414,DE714,"203,93",276218,131901,144317,1354
06431,DE715,"719,52",266928,131828,135100,371
06432,DE716,"658,65",292773,145418,147355,445
06433,DE717,"453,04",266042,132655,133387,587
06434,DE718,"482,02",233427,112797,120630,484
06435,DE719,"1397,55",411956,202592,209364,295
06436,DE71A,"222,39",232848,113592,119256,1047
06437,DE71B,"623,98",97000,48140,48860,155
06438,DE71C,"356,30",347357,171164,176193,975
06439,DE71D,"811,48",184114,90514,93600,227
06440,DE71E,"1100,69",301931,149253,152678,274
06531,DE721,"854,67",262505,129534,132971,307
06532,DE722,"1066,52",253167,124914,128253,237
06533,DE723,"738,48",171922,85410,86512,233
06534,DE724,"1262,55",245241,120775,124466,194
06535,DE725,"1458,99",107256,53707,53549,74
06611,DE731,"106,78",197984,96659,101325,1854
06631,DE732,"1380,40",220132,108993,111139,159
06632,DE733,"1097,12",121166,60407,60759,110
06633,DE734,"1292,92",235813,115972,119841,182
06634,DE735,"1538,51",180310,90229,90081,117
06635,DE736,"1848,44",157592,78655,78937,85
06636,DE737,"1024,70",100715,49582,51133,98
07111,DEB11,"105,16",112586,54391,58195,1071
07131,DEB12,"786,99",127770,62533,65237,162
07132,DEB13,"642,01",129171,64024,65147,201
07133,DEB14,"863,70",156821,76459,80362,182
07134,DEB15,"776,57",80615,39898,40717,104
07135,DEB16,"692,35",62391,31294,31097,90
07137,DEB17,"817,27",211925,104476,107449,259
07138,DEB18,"626,88",180655,88745,91910,288
07140,DEB19,"991,13",102529,50945,51584,103
07141,DEB1A,"782,32",123543,61376,62167,158
07143,DEB1B,"988,98",200302,99605,100697,203
07211,DEB21,"117,13",114914,57510,57404,981
07231,DEB22,"1167,59",111828,55763,56065,96
07232,DEB23,"1626,29",97180,48729,48451,60
07233,DEB24,"911,04",60794,30387,30407,67
07235,DEB25,"1101,50",147999,73248,74751,134
07311,DEB31,"43,76",48363,23482,24881,1105
07312,DEB32,"139,74",98520,49508,49012,705
07313,DEB33,"82,96",45362,21495,23867,547
07314,DEB34,"77,55",164718,81590,83128,2124
07315,DEB35,"97,74",209779,101620,108159,2146
07316,DEB36,"117,10",52999,25714,27285,453
07317,DEB37,"61,37",40125,19453,20672,654
07318,DEB38,"42,60",50284,24245,26039,1180
07319,DEB39,"108,73",82102,40323,41779,755
07320,DEB3A,"70,64",34260,16893,17367,485
07331,DEB3B,"588,13",127274,63379,63895,216
07332,DEB3C,"594,78",132203,64778,67425,222
07333,DEB3D,"645,48",75230,37221,38009,117
07334,DEB3E,"463,35",127303,63377,63926,275
07335,DEB3F,"639,88",104966,51600,53366,164
07336,DEB3G,"573,34",70997,35214,35783,124
07337,DEB3H,"639,84",110526,54637,55889,173
07338,DEB3I,"304,94",151546,74549,76997,497
07339,DEB3J,"605,74",208749,103161,105588,345
07340,DEB3K,"953,67",96474,47711,48763,101
08111,DE111,"207,35",623738,310492,313246,3008
08115,DE112,"617,82",381281,189163,192118,617
08116,DE113,"641,48",524127,260597,263530,817
08117,DE114,"642,36",252749,125606,127143,393
08118,DE115,"686,83",534074,264678,269396,778
08119,DE116,"858,14",419456,207145,212311,489
08121,DE117,"99,88",122567,61268,61299,1227
08125,DE118,"1099,93",334388,167488,166900,304
08126,DE119,"776,76",110181,55569,54612,142
08127,DE11A,"1484,00",191614,96187,95427,129
08128,DE11B,"1304,41",132181,65891,66290,101
08135,DE11C,"627,13",130527,64896,65631,208
08136,DE11D,"1511,57",312650,155797,156853,207
08211,DE121,"140,21",54160,25769,28391,386
08212,DE122,"173,46",307755,156686,151069,1774
08215,DE123,"1084,95",435841,216383,219458,402
08216,DE124,"738,75",227474,112509,114965,308
08221,DE125,"108,84",156267,74954,81313,1436
08222,DE126,"144,96",305780,152868,152912,2109
08225,DE127,"1126,25",142936,71596,71340,127
08226,DE128,"1061,71",541859,266128,275731,510
08231,DE129,"98,00",122247,59901,62346,1247
08235,DE12A,"797,51",155359,77683,77676,195
08236,DE12B,"573,69",196066,97100,98966,342
08237,DE12C,"870,66",116233,57866,58367,133
08311,DE131,"153,06",226393,107913,118480,1479
08315,DE132,"1378,33",257343,126585,130758,187
08316,DE133,"679,88",162082,79920,82162,238
08317,DE134,"1860,79",420106,208393,211713,226
08325,DE135,"769,43",137500,68504,68996,179
08326,DE136,"1025,26",209648,103904,105744,204
08327,DE137,"734,35",136606,68387,68219,186
08335,DE138,"817,98",280288,136421,143867,343
08336,DE139,"806,76",226708,110935,115773,281
08337,DE13A,"1131,16",167861,83106,84755,148
08415,DE141,"1092,72",282113,139634,142479,258
08416,DE142,"519,19",221837,108268,113569,427
08417,DE143,"917,71",188595,93608,94987,206
08421,DE144,"118,69",122636,60400,62236,1033
08425,DE145,"1358,67",192104,96733,95371,141
08426,DE146,"1409,75",194019,97540,96479,138
08435,DE147,"664,81",212201,104569,107632,319
08436,DE148,"1631,82",279296,138713,140583,171
08437,DE149,"1204,34",130772,65635,65137,109
09161,DE211,"133,37",132438,66825,65613,993
09162,DE212,"310,70",1450381,707150,743231,4668
09163,DE213,"37,22",61844,30273,31571,1662
09171,DE214,"569,35",108485,53369,55116,191
09172,DE215,"839,92",103907,50897,53010,124
09173,DE216,"1110,69",124930,61462,63468,112
09174,DE217,"579,18",149370,74745,74625,258
09175,DE218,"549,37",137421,68564,68857,250
09176,DE219,"1214,05",128805,65284,63521,106
09177,DE21A,"870,72",133747,67321,66426,154
09178,DE21B,"799,83",173225,88149,85076,217
09179,DE21C,"434,79",213481,104273,109208,491
09180,DE21D,"1012,22",87385,42370,45015,86
09181,DE21E,"804,38",117657,58888,58769,146
09182,DE21F,"866,23",98286,48065,50221,113
09183,DE21G,"805,31",112034,56499,55535,139
09184,DE21H,"664,25",340003,168380,171623,512
09185,DE21I,"739,81",94654,47580,47074,128
09186,DE21J,"761,14",124128,63325,60803,163
09187,DE21K,"1439,54",256074,126896,129178,178
09188,DE21L,"487,71",133621,64772,68849,274
09189,DE21M,"1534,00",174162,85999,88163,114
09190,DE21N,"966,37",132906,65974,66932,138
09261,DE221,"65,81",69211,33513,35698,1052
09262,DE222,"69,57",50566,23945,26621,727
09263,DE223,"67,58",46806,23519,23287,693
09271,DE224,"861,31",116596,57851,58745,135
09272,DE225,"984,14",78122,38921,39201,79
09273,DE226,"1065,97",118965,60306,58659,112
09274,DE227,"1347,90",154577,78468,76109,115
09275,DE228,"1530,28",188336,93347,94989,123
09276,DE229,"974,91",76812,38402,38410,79
09277,DE22A,"1281,41",119218,59402,59816,93
09278,DE22B,"1201,93",98806,49683,49123,82
09279,DE22C,"877,79",94104,48369,45735,107
09361,DE231,"50,14",41861,20571,21290,835
09362,DE232,"80,70",145465,69969,75496,1803
09363,DE233,"70,55",42055,20052,22003,596
09371,DE234,"1255,75",103568,51767,51801,82
09372,DE235,"1520,16",126359,63117,63242,83
09373,DE236,"1344,12",130385,65671,64714,97
09374,DE237,"1427,68",95078,47226,47852,67
09375,DE238,"1391,90",189390,94531,94859,136
09376,DE239,"1464,98",144864,72784,72080,99
09377,DE23A,"1084,23",73314,36426,36888,68
09461,DE241,"54,62",73331,34767,38564,1343
09462,DE242,"66,92",72148,34850,37298,1078
09463,DE243,"48,29",41257,20004,21253,854
09464,DE244,"58,03",44660,21342,23318,770
09471,DE245,"1167,84",145570,72906,72664,125
09472,DE246,"1273,76",104306,51516,52790,82
09473,DE247,"590,47",86599,42781,43818,147
09474,DE248,"642,79",114834,56865,57969,179
09475,DE249,"892,52",96429,47008,49421,108
09476,DE24A,"651,53",67916,33475,34441,104
09477,DE24B,"658,34",72468,35503,36965,110
09478,DE24C,"519,95",66655,32817,33838,128
09479,DE24D,"606,43",73185,35470,37715,121
09561,DE251,"99,91",41159,19778,21381,412
09562,DE252,"76,95",108336,53454,54882,1408
09563,DE253,"63,35",124171,60669,63502,1960
09564,DE254,"186,38",509975,247931,262044,2736
09565,DE255,"40,82",40428,19710,20718,990
09571,DE256,"1971,85",181314,90933,90381,92
09572,DE257,"564,66",134136,66722,67414,238
09573,DE258,"307,56",114291,55381,58910,372
09574,DE259,"799,57",167643,82530,85113,210
09575,DE25A,"1267,56",98751,49217,49534,78
09576,DE25B,"895,39",125140,62231,62909,140
09577,DE25C,"970,91",93342,46525,46817,96
09661,DE261,"62,47",68986,33288,35698,1104
09662,DE262,"35,70",51969,25160,26809,1456
09663,DE263,"87,63",124873,59159,65714,1425
09671,DE264,"699,16",173695,86543,87152,248
09672,DE265,"1136,96",103106,50623,52483,91
09673,DE266,"1021,77",79723,39540,40183,78
09674,DE267,"956,38",84581,42412,42169,88
09675,DE268,"684,18",89306,44796,44510,131
09676,DE269,"715,86",128446,64062,64384,179
09677,DE26A,"1321,42",126123,62856,63267,95
09678,DE26B,"841,46",114813,57406,57407,136
09679,DE26C,"968,41",160427,79757,80670,166
09761,DE271,"146,86",286374,140323,146051,1950
09762,DE272,"40,03",42731,20999,21732,1067
09763,DE273,"63,28",66947,33106,33841,1058
09764,DE274,"70,14",42841,21082,21759,611
09771,DE275,"780,30",130916,65241,65675,168
09772,DE276,"1071,11",245600,122030,123570,229
09773,DE277,"792,22",94575,47230,47345,119
09774,DE278,"762,44",123153,62073,61080,162
09775,DE279,"515,87",170309,84606,85703,330
09776,DE27A,"323,45",80429,39550,40879,249
09777,DE27B,"1394,91",137709,68750,68959,99
09778,DE27C,"1230,06",140419,70572,69847,114
09779,DE27D,"1274,69",131345,66381,64964,103
09780,DE27E,"1528,01",152672,75342,77330,100
10041,DEC01,"410,63",327380,160361,167019,797
10042,DEC02,"555,16",103997,51531,52466,187
10043,DEC03,"249,25",133735,65647,68088,537
10044,DEC04,"459,03",197009,96613,100396,429
10045,DEC05,"418,39",144584,70455,74129,346
10046,DEC06,"476,23",88892,44024,44868,187
11000,DE300,"891,68",3520031,1726533,1793498,3948
12051,DE401,"229,72",71574,35323,36251,312
12052,DE402,"165,16",99687,49100,50587,604
12053,DE403,"147,85",58092,27989,30103,393
12054,DE404,"188,26",167745,80854,86891,891
12060,DE405,"1479,68",177411,87997,89414,120
12061,DE406,"2274,49",164528,81587,82941,72
12062,DE407,"1899,57",104673,51820,52853,55
12063,DE408,"1727,30",158236,78316,79920,92
12064,DE409,"2158,65",190714,94906,95808,88
12065,DE40A,"1808,20",207524,102478,105046,115
12066,DE40B,"1223,09",112450,55287,57163,92
12067,DE40C,"2256,75",182397,90953,91444,81
12068,DE40D,"2526,56",99110,49332,49778,39
12069,DE40E,"2591,94",210910,104720,106190,81
12070,DE40F,"2138,59",77573,38556,39017,36
12071,DE40G,"1657,43",117635,58059,59576,71
12072,DE40H,"2104,22",163553,81514,82039,78
12073,DE40I,"3076,92",121014,59492,61522,39
13003,DE803,"181,26",206011,101078,104933,1137
13004,DE804,"130,52",96800,47028,49772,742
13071,DE80J,"5470,35",262517,129182,133335,48
13072,DE80K,"3422,52",213473,106674,106799,62
13073,DE80L,"3207,38",224820,110885,113935,70
13074,DE80M,"2118,52",156270,77871,78399,74
13075,DE80N,"3929,73",238358,117353,121005,61
13076,DE80O,"4752,46",214113,107761,106352,45
14511,DED41,"221,05",248645,122748,125897,1125
14521,DED42,"1827,90",347665,170364,177301,190
14522,DED43,"2116,32",312450,155084,157366,148
14523,DED44,"1412,42",232318,113174,119144,164
14524,DED45,"949,79",324534,158067,166467,342
14612,DED21,"328,48",543825,270410,273415,1656
14625,DED2C,"2395,60",306273,151349,154924,128
14626,DED2D,"2111,42",260000,127325,132675,123
14627,DED2E,"1454,59",245244,121132,124112,169
14628,DED2F,"1654,18",247412,122565,124847,150
14713,DED51,"297,80",560472,274414,286058,1882
14729,DED52,"1651,39",258408,126877,131531,156
14730,DED53,"2028,42",197605,98052,99553,97
15001,DEE01,"244,74",82919,40311,42608,339
15002,DEE02,"135,02",236991,114581,122410,1755
15003,DEE03,"201,00",235723,115810,119913,1173
15081,DEE04,"2293,05",86164,43104,43060,38
15082,DEE05,"1453,53",164817,80940,83877,113
15083,DEE07,"2366,65",173473,86819,86654,73
15084,DEE08,"1413,69",184081,91276,92805,130
15085,DEE09,"2104,52",221366,109026,112340,105
15086,DEE06,"1576,85",91693,45870,45823,58
15087,DEE0A,"1448,84",141408,69831,71577,98
15088,DEE0B,"1433,67",186431,92339,94092,130
15089,DEE0C,"1426,73",196695,96161,100534,138
15090,DEE0D,"2423,14",115262,57194,58068,48
15091,DEE0E,"1930,30",128447,63427,65020,67
16051,DEG01,"269,91",210118,102259,107859,778
16052,DEG02,"152,19",96011,46414,49597,631
16053,DEG03,"114,76",109527,54467,55060,954
16054,DEG04,"103,03",36778,18071,18707,357
16055,DEG05,"84,48",64131,31002,33129,759
16056,DEG0N,"104,17",42417,20810,21607,407
16061,DEG06,"943,07",101325,50927,50398,107
16062,DEG07,"713,91",85355,42292,43063,120
16063,DEG0P,"1307,43",125655,62914,62741,96
16064,DEG09,"979,69",105273,52367,52906,107
16065,DEG0A,"1037,89",77110,38432,38678,74
16066,DEG0B,"1210,73",124623,62268,62355,103
16067,DEG0C,"936,08",136831,68341,68490,146
16068,DEG0D,"806,84",70600,35274,35326,88
16069,DEG0E,"938,42",64524,32271,32253,69
16070,DEG0F,"843,71",109620,55077,54543,130
16071,DEG0G,"804,48",82127,40784,41343,102
16072,DEG0H,"433,61",56818,27912,28906,131
16073,DEG0I,"1036,03",109278,53769,55509,105
16074,DEG0J,"815,25",86184,43322,42862,106
16075,DEG0K,"1151,30",82951,41022,41929,72
16076,DEG0L,"845,98",101114,49814,51300,120
16077,DEG0M,"569,41",92344,45330,47014,162
